6 6
0 0 0 0 0 0
1 1 0 4 0 5
1 1 1 0 1 5
2 0 0 1 1 5
1 3 3 1 0 5
5 5 5 5 5 5
